4 4 4 4 4 4 4 4 4 4 4 4 4 4 4 4 4 4 4 4 4 4 4 4 4 4 4 4 4 4 4 4 4 4 4 4 4 4 4 4 4 4 4 4 4 4 4 4 4 4
4 4 4 4 4 4 4 4 4 4 4 4 4 4 4 4 4 4 4 4 4 4 4 4 4 4 4 4 4 4 4 4 4 4 4 4 4 4 4 4 4 4 4 4 4 4 4 4 4 4
4 4 4 4 4 4 4 4 4 4 1 1 1 1 1 1 1 1 1 1 2 2 2 2 2 2 2 2 2 4 4 4 4 4 4 4 4 4 4 4 4 4 4 4 4 4 4 4 4 4
4 4 4 1 1 1 4 4 4 4 1 1 1 1 1 1 1 1 1 1 2 5 5 5 5 5 5 5 2 4 4 4 4 4 4 4 4 4 4 4 1 1 1 1 1 1 4 4 4 4
4 4 1 1 1 1 4 4 4 4 1 1 1 1 1 1 1 1 1 1 2 5 5 5 5 5 5 5 2 4 4 1 1 1 1 1 1 1 1 1 1 1 1 1 1 1 1 4 4 4
4 4 1 1 1 1 4 4 4 4 1 1 1 1 1 1 1 1 1 1 2 5 5 5 5 5 5 5 2 4 4 1 4 4 4 4 4 4 4 4 1 1 1 1 1 1 1 4 4 4
4 4 1 1 1 1 4 4 4 4 1 1 1 1 1 1 1 1 1 1 2 5 5 5 5 5 5 5 2 4 4 1 4 4 4 4 4 4 4 4 1 1 1 1 1 1 1 4 4 4
4 4 1 1 1 1 4 4 4 4 3 3 1 1 1 1 1 1 1 1 2 5 5 5 5 5 5 5 2 4 4 1 4 4 4 4 4 4 4 4 4 1 1 1 1 1 4 4 4 4
4 4 1 1 1 3 3 4 0 0 0 3 3 1 1 1 1 1 1 1 2 2 2 2 5 2 2 2 2 4 4 1 4 4 4 4 4 4 4 4 4 4 4 4 4 4 4 4 4 4
4 4 1 1 1 3 0 0 0 0 0 0 3 3 1 1 1 1 1 1 1 1 1 1 1 1 1 1 1 4 4 1 4 4 4 4 4 4 4 4 4 4 4 4 4 4 4 4 4 4
4 4 1 1 1 3 0 0 0 0 0 0 0 3 1 1 1 1 1 1 1 1 1 1 1 1 1 1 1 1 4 1 4 4 2 2 2 2 2 2 2 2 2 2 2 2 4 4 4 4
4 4 1 1 1 3 0 0 0 0 0 0 0 3 1 1 1 1 1 1 1 1 1 1 1 1 1 1 1 1 4 1 4 4 2 5 5 5 2 5 5 5 5 5 5 2 4 4 4 4
4 4 1 1 1 3 0 0 0 0 0 0 0 3 1 1 1 1 1 1 1 1 1 1 1 1 1 1 1 1 1 1 4 4 2 5 5 5 2 5 5 5 5 5 5 2 4 4 4 4
4 4 1 1 1 3 0 0 0 0 0 0 0 3 1 1 1 1 1 1 1 1 1 1 1 1 1 1 1 1 1 1 4 4 2 5 5 5 5 5 5 5 5 5 5 2 4 4 4 4
4 4 1 1 3 3 0 0 0 0 0 0 0 3 3 1 1 1 1 1 1 1 1 1 1 1 1 1 1 1 1 1 1 1 2 5 5 5 2 5 5 5 5 5 5 2 4 4 4 4
4 4 1 1 3 0 0 0 0 0 0 0 0 0 3 1 1 1 1 1 1 1 1 1 1 1 1 1 1 1 1 1 1 1 2 5 5 5 2 5 5 5 5 5 5 2 4 4 4 4
4 4 1 1 3 0 0 0 0 0 0 0 0 0 3 1 1 1 1 1 1 1 1 1 1 1 1 1 1 1 1 1 1 1 2 5 5 5 2 5 5 5 5 5 5 2 4 4 4 4
4 4 1 1 3 0 0 0 0 0 0 0 0 0 3 1 1 1 1 1 1 1 1 1 1 1 1 1 1 1 1 1 1 1 2 5 5 5 2 5 5 5 5 5 5 2 4 4 4 4
4 4 1 1 3 0 0 0 0 0 0 0 0 0 3 1 1 1 1 1 1 1 1 1 1 1 1 1 1 1 1 1 1 1 2 5 5 5 2 5 5 5 5 5 5 2 4 4 4 4
4 4 1 1 3 0 0 0 0 0 0 0 0 3 3 1 1 1 1 1 1 1 1 1 1 1 1 1 1 1 1 1 1 1 2 5 5 5 2 5 5 5 5 5 5 2 4 4 4 4
4 4 1 1 3 0 0 0 0 0 0 0 0 3 1 1 1 1 1 1 1 1 1 1 1 1 1 1 1 1 1 1 1 1 2 5 5 5 2 5 5 5 5 5 5 2 4 4 4 4
4 4 1 1 3 0 0 0 0 0 0 0 0 3 1 1 1 1 1 1 1 1 1 1 1 1 1 1 1 1 1 1 1 1 2 5 5 5 2 5 5 5 5 5 5 2 4 4 4 4
4 4 1 1 3 3 0 0 0 0 0 0 0 3 1 1 1 1 1 1 1 1 1 1 1 1 1 1 1 1 1 1 1 1 2 5 5 5 2 5 5 5 5 5 5 2 4 4 4 4
4 4 1 1 1 3 0 0 0 0 0 0 3 3 1 1 1 1 1 1 1 1 1 1 1 1 1 1 1 1 1 1 1 1 2 2 2 2 2 2 2 2 2 5 2 2 4 4 4 4
4 4 1 1 1 3 0 0 0 0 0 0 3 1 1 1 1 1 1 1 1 1 1 1 1 1 1 1 1 1 1 1 1 1 1 1 1 1 1 1 1 1 1 1 1 1 1 1 4 4
4 4 1 1 1 3 3 0 0 0 3 3 3 1 1 1 1 1 1 1 1 1 1 1 1 1 1 1 1 1 1 1 1 1 1 1 1 1 1 1 1 1 1 1 1 1 1 1 4 4
4 4 1 1 1 1 3 3 3 3 3 1 1 1 1 1 1 1 1 1 1 1 1 1 1 1 1 1 1 1 1 1 1 1 1 1 1 1 1 1 1 1 1 1 1 1 1 1 4 4
4 4 1 1 1 1 1 1 1 1 1 1 1 1 1 1 1 1 1 1 1 1 1 1 1 1 1 1 1 1 1 1 1 1 1 1 1 1 1 1 1 1 1 1 1 1 1 1 4 4
4 4 1 1 1 1 1 1 1 1 1 1 1 1 1 1 1 1 1 1 1 1 1 1 1 1 1 1 1 1 1 1 1 1 1 1 1 1 1 1 1 1 1 1 1 1 1 1 4 4
4 4 1 1 1 1 1 1 1 1 1 1 1 1 1 1 1 1 1 1 1 1 1 1 1 1 1 1 1 1 1 1 1 1 1 1 1 1 1 1 1 1 1 1 1 1 1 1 4 4
4 4 1 1 1 1 1 1 1 1 1 1 1 1 1 1 1 1 1 1 1 1 1 1 1 1 1 1 1 1 1 1 1 1 1 1 1 1 1 1 1 1 1 1 1 1 1 1 4 4
4 4 1 1 1 1 1 1 1 1 1 1 1 1 1 1 1 1 1 1 1 1 1 1 1 1 1 1 1 1 1 1 1 1 1 1 1 1 1 1 1 1 1 1 1 1 1 1 4 4
4 4 1 1 1 1 1 1 1 1 1 1 1 1 1 1 1 1 1 1 1 1 1 1 1 1 1 1 1 1 1 1 1 1 1 1 1 1 1 1 1 1 1 1 1 1 1 1 4 4
4 4 4 4 4 4 4 4 1 1 1 4 4 4 4 4 4 4 4 4 4 1 1 1 1 1 1 1 1 1 1 1 1 1 1 1 1 1 1 1 1 1 1 1 1 1 1 1 4 4
4 4 4 4 4 4 4 1 1 1 1 1 4 4 4 4 4 4 4 4 4 1 1 1 1 1 1 1 1 1 1 1 1 1 1 1 1 1 1 1 1 1 1 1 1 1 1 1 4 4
4 4 4 4 4 4 4 1 1 1 1 1 4 4 4 4 4 4 4 4 4 1 1 1 1 1 1 1 1 1 1 1 1 1 1 1 1 1 1 1 1 1 1 1 1 1 1 1 4 4
4 4 4 4 4 4 4 1 1 1 1 1 4 4 4 4 4 4 4 4 4 4 4 4 1 1 1 1 1 1 1 1 1 1 1 1 1 1 1 1 1 1 1 1 1 3 3 3 3 4
4 4 4 4 4 4 4 1 1 1 1 1 4 4 4 4 4 4 4 4 4 4 4 4 4 1 1 1 1 1 1 1 1 1 1 1 1 1 1 1 1 3 3 3 3 3 0 0 0 0
4 4 4 4 4 4 1 1 1 1 1 1 1 4 4 4 4 4 4 4 4 4 4 4 4 4 4 4 1 1 1 1 1 1 1 1 1 1 1 1 1 3 0 0 0 0 0 0 0 0
4 4 4 4 1 1 1 1 1 1 1 1 1 1 1 4 4 4 4 4 4 4 4 4 4 4 4 4 4 1 1 1 1 1 1 1 1 1 1 1 1 3 0 0 0 0 0 0 0 0
4 4 4 1 1 1 1 1 1 1 1 1 1 1 1 1 1 4 4 4 4 4 4 4 4 4 4 4 4 1 1 1 1 1 1 1 1 1 1 1 3 3 0 0 0 0 0 0 0 0
4 4 4 1 1 1 1 3 3 3 3 3 3 3 1 1 1 1 4 4 4 4 4 4 4 4 4 4 4 4 1 1 1 1 1 1 1 1 1 1 3 0 0 0 0 0 0 0 0 0
4 4 4 1 1 1 3 3 0 0 0 0 0 3 3 1 1 1 4 4 4 4 4 4 4 4 4 4 4 4 4 4 1 1 1 1 1 1 1 1 3 0 0 0 0 0 0 0 0 0
4 4 4 1 1 3 3 0 0 0 0 0 0 0 3 1 1 1 4 4 4 4 4 4 4 4 4 4 4 4 4 4 4 1 1 1 1 1 1 1 3 0 0 0 0 0 0 0 0 0
4 4 4 1 3 3 0 0 0 0 0 0 0 0 3 3 1 1 4 4 4 4 4 4 4 4 4 4 4 4 4 4 4 4 1 1 1 1 1 1 3 0 0 0 0 0 0 0 0 0
4 4 4 1 3 0 0 0 0 0 0 0 0 0 0 3 1 1 4 4 4 4 4 4 4 4 4 4 4 4 4 4 4 4 4 1 1 1 1 1 3 0 0 0 0 0 0 0 0 0
4 4 4 1 3 0 0 0 0 0 0 0 0 0 0 3 1 1 4 4 4 4 4 4 4 4 4 4 4 4 4 4 4 4 4 1 1 1 1 1 3 0 0 0 0 0 0 0 0 0
4 4 4 4 4 3 0 0 0 0 0 0 0 0 3 4 4 4 4 4 4 4 4 4 4 4 4 4 4 4 4 4 4 4 4 4 1 1 1 1 3 0 0 0 0 0 0 0 0 0
4 4 4 4 4 3 3 0 0 0 0 0 0 3 3 4 4 4 4 4 4 4 4 4 4 4 4 4 4 4 4 4 4 4 4 4 4 4 4 4 3 0 0 0 0 0 0 0 0 0
4 4 4 4 4 4 3 3 0 0 0 0 3 3 4 4 4 4 4 4 4 4 4 4 4 4 4 4 4 4 4 4 4 4 4 4 4 4 4 4 4 0 0 0 0 0 0 0 0 0
